NO ./textures/bg1.png
SO ./textures/bg1.png
WE ./textures/bg1.png
EA ./textures/bg1.png
F 123,123,123
C 255,255,255

1111111111111111111111111111111111111111111111
1000000000000000000000000000000010000000000001
10000000000000000001010010100000C0000000000001
1000000000000000000000000000000010000000000001
1000000000000000000101001010000011111111111111
1000000000000000000000000000000010000000000001
1000000000000000000101001010000010000000000001
1000000000000000000000000000000010000000000001
100000000C000000000101001010000010000000000001
100000000C000000000000E000000000C0000000000001
100000000C000000000101001010000010000000000001
1000000000000000000000000000000010000000000001
1000000000000000000101001010000010000000000001
1000000000000000000000000000000010000000000001
10000000000000000001010010100000C0000000000001
1000000000000000000000000000000010000000000001
1000000000000000000101001010000010000000000001
1000000000000000000000000000000010000000000001
1111111111111111111111111111111111111111111111
