NO ./path_to_the_north_texture
SO ./path_to_the_south_texture



WE ./path_to_the_ west_texture




EA         ./path_to_the _east_texture      

F 0,0,       0


C 255,         255,       255





        1111111111111111111111111
        1000000000110000000000001 111111
        1011000001110000000000001 100001
        1001000000000000000000001 111111
111111111011000001110000000000001
10000000001100000111N111111111111
11110111111111011100000010001
11110111111111011101010010001
11000000110101011100000010001
10000000000000001100000010001
10000000000000001101010010001
1100000111010101111101111000111
11110111 1110101 101111010001
11111111 1111111 111111111111
