NO ./textures/bg1.png
SO ./textures/bg1.png



WE ./textures/bg1.png




EA         ./textures/bg1.png

F 123,123,       123


C 255,         255,       255






            1111111       1111
            11111111      1111
            111101111     1111
            1111001111    1111
            11110001111   1111
            111100001111  1111
            1111000001111 1111
            111100000011111111
            111100000001111111
                10000001
                10000001
                10000001
                10000001
                10000001
                10000001
                10000001
                10000001
                10000001
                10000001
                10000001
1111111111111111111100011111111111111111111111
100C000000000000000000000000000000000000000001
10CCC00000000000000101001010000000000000000001
100C000000000000000000000000000000000000000001
1000000000000000000101001010000000000000000001
1000000000000000000000000000000000000000000001
1000000000000000000101001010000000000000000001
1000000000000000000000000000000000000000000001
1000000000000000000101001010000000000000000001
1000000000000000000000000000000000000000000001
1000000000000000000101001010000000000000000001
1000000000000000000000000000000000000000000001
1000000000000000000101001010000000000000000001
1000000000000000000000000000000000000000000001
1000000000000000000101001010000000000000000001
1000000000000000000000000000000000000000000001
1000000000000000000101001010000000000000000001
10000000000000000000N0000000000000000000000001
1111111111111111111111111111111111111111111111
