NO ./textures/bg1.png
SO ./textures/bg2.png



WE ./textures/bg3.png




EA         ./textures/bg4.png

F 0,0,       0


C 255,         255,       255





1111111111111111111111111111111111111111111111
1000000000000000000000000000000000000000000001
1000000000000000000101001010000000000000000001
1000000000000000000000000000000000000000000001
1000000000000000000101001010000000000000000001
1000000000000000000000000000000000000000000001
1000000000000000000101001010000000000000000001
1000000000000000000000000000000000000000000001
1000000000000000000101001010000000000000000001
1000000000000000000000000000000000000000000001
1000000000000000000101001010000000000000000001
1000000000000000000000000000000000000000000001
1000000000000000000101001010000000000000000001
1000000000000000000000000000000000000000000001
1000000000000000000101001010000000000000000001
1000000000000000000000000000000000000000000001
1000000000000000000101001010000000000000000001
10000000000000000000N0000000000000000000000001
1111111111111111111111111111111111111111111111
