NO ./textures/bg1.png
SO ./textures/bg2.png



WE ./textures/bg3.png




EA         ./textures/bg4.png

F 123,123,       123


C 255,         255,       00000000000000000000255
1111
1N1
11
1
1
1
1
1
1
1
1
1
1
111111